90 30
#........................................................................................#
..........................................................................................
..........................................................................................
.................##..................................................####.................
.................########..........................................######.................
.................######..##....................................##########.................
.................######....####............................####....######.................
...................####........##........................##........####...................
...................####..........####....########....####..........####...................
.....................##..............####........####..............##.....................
.....................##............................................##.....................
.......................##........................................##.......................
.........................##..##............................##..##.........................
...........................##................................##...........................
...........................##................................##...........................
.........................##......####................####......##.........................
.........................##....##..####............##..####....##.........................
.........................##....########............########....##.........................
.........................##......####......####......####......##.........................
.......................##........................................##.......................
.......................##....#####.....##..####..##.....#####....##.......................
.......................##...<#####.....############.....#####>...##.......................
.........................##...###........##....##........###...##.........................
...........................##............###..###............##...........................
.............................####..........####..........####.............................
.................................######............######.................................
.......................................############.......................................
..........................................................................................
..........................................................................................
#........................................................................................#