14 10
..............
..............
........###...
......##...##.
.....#X.....##
....####...##.
...#>###..#...
...#..$...#...
....####..#...
........###...